,Month,Domestic,International,total_count,Name
0,2019-12,50755,11647,62402,Australia
1,2020-01,48075,11583,59658,Australia
2,2020-02,47908,10785,58693,Australia
3,2020-03,45903,7906,53809,Australia
4,2020-04,17595,2135,19730,Australia
5,2020-05,20695,2589,23284,Australia
6,2020-06,24311,2423,26734,Australia
7,2020-07,26360,2555,28915,Australia
8,2020-08,20715,2591,23306,Australia
9,2020-09,21868,2629,24497,Australia
10,2020-10,24173,3063,27236,Australia
11,2020-11,28997,3230,32227,Australia
12,2020-12,33388,3465,36853,Australia
13,2021-01,30630,3181,33811,Australia
14,2019-12,3203,2372,5575,South Africa
15,2020-01,2072,1969,4041,South Africa
16,2020-02,2532,2203,4735,South Africa
17,2020-03,2136,1764,3900,South Africa
18,2020-04,88,340,428,South Africa
19,2020-05,139,463,602,South Africa
20,2020-06,422,523,945,South Africa
21,2020-07,622,622,1244,South Africa
22,2020-08,782,705,1487,South Africa
23,2020-09,1150,721,1871,South Africa
24,2020-10,1475,1110,2585,South Africa
25,2020-11,1552,1116,2668,South Africa
26,2020-12,2574,1173,3747,South Africa
27,2021-01,1813,909,2722,South Africa
28,2019-12,21291,14820,36111,India
29,2020-01,22029,15640,37669,India
30,2020-02,21664,14609,36273,India
31,2020-03,16530,9121,25651,India
32,2020-04,593,1317,1910,India
33,2020-05,1663,2447,4110,India
34,2020-06,4949,4279,9228,India
35,2020-07,4926,5178,10104,India
36,2020-08,5057,4769,9826,India
37,2020-09,5995,4442,10437,India
38,2020-10,11084,6020,17104,India
39,2020-11,12293,6685,18978,India
40,2020-12,14388,7297,21685,India
41,2021-01,16107,7681,23788,India
42,2019-12,838245,72664,910909,United States
43,2020-01,875715,72864,948579,United States
44,2020-02,914154,73956,988110,United States
45,2020-03,805240,59685,864925,United States
46,2020-04,425069,15825,440894,United States
47,2020-05,552491,18391,570882,United States
48,2020-06,691872,22223,714095,United States
49,2020-07,818895,26939,845834,United States
50,2020-08,856972,27532,884504,United States
51,2020-09,802657,28952,831609,United States
52,2020-10,842165,32842,875007,United States
53,2020-11,787367,34347,821714,United States
54,2020-12,768844,40551,809395,United States
55,2021-01,738192,37987,776179,United States
56,2019-12,7325,12835,20160,Japan
57,2020-01,8217,12052,20269,Japan
58,2020-02,7509,11877,19386,Japan
59,2020-03,7147,5922,13069,Japan
60,2020-04,3946,2299,6245,Japan
61,2020-05,2318,2474,4792,Japan
62,2020-06,4594,2689,7283,Japan
63,2020-07,7321,3043,10364,Japan
64,2020-08,9071,3061,12132,Japan
65,2020-09,7200,3285,10485,Japan
66,2020-10,7983,3381,11364,Japan
67,2020-11,10238,3598,13836,Japan
68,2020-12,10942,6370,17312,Japan
69,2021-01,5742,6492,12234,Japan
70,2019-12,6674,18216,24890,Russian Federation
71,2020-01,7206,18833,26039,Russian Federation
72,2020-02,6371,17756,24127,Russian Federation
73,2020-03,7220,12719,19939,Russian Federation
74,2020-04,1564,1630,3194,Russian Federation
75,2020-05,1772,2376,4148,Russian Federation
76,2020-06,4229,2365,6594,Russian Federation
77,2020-07,5638,2905,8543,Russian Federation
78,2020-08,6736,5658,12394,Russian Federation
79,2020-09,8750,6915,15665,Russian Federation
80,2020-10,6614,9051,15665,Russian Federation
81,2020-11,5982,6660,12642,Russian Federation
82,2020-12,6749,6046,12795,Russian Federation
83,2021-01,6176,5757,11933,Russian Federation
84,2019-12,861,9672,10533,Qatar
85,2020-01,851,9937,10788,Qatar
86,2020-02,864,9810,10674,Qatar
87,2020-03,1201,7869,9070,Qatar
88,2020-04,752,3567,4319,Qatar
89,2020-05,538,3982,4520,Qatar
90,2020-06,808,4212,5020,Qatar
91,2020-07,1241,5265,6506,Qatar
92,2020-08,431,5650,6081,Qatar
93,2020-09,1219,5894,7113,Qatar
94,2020-10,1314,6560,7874,Qatar
95,2020-11,1463,6588,8051,Qatar
96,2020-12,1068,6845,7913,Qatar
97,2021-01,863,7191,8054,Qatar
98,2019-12,4170,12143,16313,Malaysia
99,2020-01,4154,12040,16194,Malaysia
100,2020-02,4234,10753,14987,Malaysia
101,2020-03,2131,5760,7891,Malaysia
102,2020-04,294,1149,1443,Malaysia
103,2020-05,509,1245,1754,Malaysia
104,2020-06,682,1274,1956,Malaysia
105,2020-07,1301,1482,2783,Malaysia
106,2020-08,1565,1574,3139,Malaysia
107,2020-09,2017,1606,3623,Malaysia
108,2020-10,842,1823,2665,Malaysia
109,2020-11,698,1874,2572,Malaysia
110,2020-12,1464,2184,3648,Malaysia
111,2021-01,970,2259,3229,Malaysia
112,2019-12,2297,21617,23914,United Arab Emirates
113,2020-01,2225,21529,23754,United Arab Emirates
114,2020-02,1742,17921,19663,United Arab Emirates
115,2020-03,1724,13487,15211,United Arab Emirates
116,2020-04,462,3465,3927,United Arab Emirates
117,2020-05,594,5059,5653,United Arab Emirates
118,2020-06,991,5950,6941,United Arab Emirates
119,2020-07,1148,7421,8569,United Arab Emirates
120,2020-08,1094,8018,9112,United Arab Emirates
121,2020-09,917,8676,9593,United Arab Emirates
122,2020-10,852,11138,11990,United Arab Emirates
123,2020-11,994,11521,12515,United Arab Emirates
124,2020-12,1058,13393,14451,United Arab Emirates
125,2021-01,1334,13442,14776,United Arab Emirates
126,2019-12,316,17116,17432,Singapore
127,2020-01,284,16551,16835,Singapore
128,2020-02,199,15455,15654,Singapore
129,2020-03,99,7749,7848,Singapore
130,2020-04,39,2258,2297,Singapore
131,2020-05,50,2547,2597,Singapore
132,2020-06,89,3325,3414,Singapore
133,2020-07,80,3483,3563,Singapore
134,2020-08,84,3655,3739,Singapore
135,2020-09,105,3667,3772,Singapore
136,2020-10,106,3916,4022,Singapore
137,2020-11,132,4320,4452,Singapore
138,2020-12,145,4981,5126,Singapore
139,2021-01,192,5324,5516,Singapore
140,2019-12,654,18503,19157,Hong Kong
141,2020-01,611,17707,18318,Hong Kong
142,2020-02,429,11542,11971,Hong Kong
143,2020-03,446,8019,8465,Hong Kong
144,2020-04,471,6681,7152,Hong Kong
145,2020-05,499,8245,8744,Hong Kong
146,2020-06,514,7141,7655,Hong Kong
147,2020-07,384,7061,7445,Hong Kong
148,2020-08,296,7018,7314,Hong Kong
149,2020-09,315,7566,7881,Hong Kong
150,2020-10,409,7741,8150,Hong Kong
151,2020-11,426,9081,9507,Hong Kong
152,2020-12,390,9407,9797,Hong Kong
153,2021-01,363,8438,8801,Hong Kong
154,2019-12,21534,33891,55425,Canada
155,2020-01,21899,34340,56239,Canada
156,2020-02,22747,34789,57536,Canada
157,2020-03,21419,29014,50433,Canada
158,2020-04,8770,4471,13241,Canada
159,2020-05,9796,4437,14233,Canada
160,2020-06,14812,5454,20266,Canada
161,2020-07,20107,7200,27307,Canada
162,2020-08,21382,7839,29221,Canada
163,2020-09,19716,7446,27162,Canada
164,2020-10,17634,8061,25695,Canada
165,2020-11,15284,8289,23573,Canada
166,2020-12,14215,9727,23942,Canada
167,2021-01,12991,8455,21446,Canada
168,2019-12,24362,78648,103010,Germany
169,2020-01,23403,77895,101298,Germany
170,2020-02,24975,80251,105226,Germany
171,2020-03,18876,54376,73252,Germany
172,2020-04,10244,13096,23340,Germany
173,2020-05,19264,15839,35103,Germany
174,2020-06,22131,23709,45840,Germany
175,2020-07,26200,42602,68802,Germany
176,2020-08,25194,49146,74340,Germany
177,2020-09,27835,47403,75238,Germany
178,2020-10,22036,44363,66399,Germany
179,2020-11,17609,28201,45810,Germany
180,2020-12,12451,27841,40292,Germany
181,2021-01,10953,24956,35909,Germany
182,2019-12,835,26479,27314,Netherlands
183,2020-01,771,26149,26920,Netherlands
184,2020-02,836,26657,27493,Netherlands
185,2020-03,1139,19754,20893,Netherlands
186,2020-04,985,3421,4406,Netherlands
187,2020-05,1809,5265,7074,Netherlands
188,2020-06,1980,7811,9791,Netherlands
189,2020-07,1969,14402,16371,Netherlands
190,2020-08,2023,19157,21180,Netherlands
191,2020-09,2376,18300,20676,Netherlands
192,2020-10,1566,16892,18458,Netherlands
193,2020-11,1656,12328,13984,Netherlands
194,2020-12,992,13324,14316,Netherlands
195,2021-01,1047,12334,13381,Netherlands
196,2019-12,10780,43411,54191,France
197,2020-01,11419,42937,54356,France
198,2020-02,12022,45563,57585,France
199,2020-03,8210,29666,37876,France
200,2020-04,1760,4065,5825,France
201,2020-05,5309,5323,10632,France
202,2020-06,9792,9795,19587,France
203,2020-07,14419,23173,37592,France
204,2020-08,13591,28318,41909,France
205,2020-09,15642,23430,39072,France
206,2020-10,13034,20778,33812,France
207,2020-11,7268,13422,20690,France
208,2020-12,8003,16089,24092,France
209,2021-01,8902,15067,23969,France
210,2019-12,488,12387,12875,"Korea, Republic of"
211,2020-01,558,14300,14858,"Korea, Republic of"
212,2020-02,560,12484,13044,"Korea, Republic of"
213,2020-03,311,5104,5415,"Korea, Republic of"
214,2020-04,146,4633,4779,"Korea, Republic of"
215,2020-05,147,5244,5391,"Korea, Republic of"
216,2020-06,153,4812,4965,"Korea, Republic of"
217,2020-07,128,4926,5054,"Korea, Republic of"
218,2020-08,57,4053,4110,"Korea, Republic of"
219,2020-09,143,5465,5608,"Korea, Republic of"
220,2020-10,966,6227,7193,"Korea, Republic of"
221,2020-11,1151,6676,7827,"Korea, Republic of"
222,2020-12,2285,7306,9591,"Korea, Republic of"
223,2021-01,266,4927,5193,"Korea, Republic of"
224,2019-12,1365,3673,5038,China
225,2020-01,1234,3414,4648,China
226,2020-02,768,1188,1956,China
227,2020-03,1094,962,2056,China
228,2020-04,892,1382,2274,China
229,2020-05,1053,2104,3157,China
230,2020-06,1517,2132,3649,China
231,2020-07,1760,1757,3517,China
232,2020-08,1318,1277,2595,China
233,2020-09,1248,1259,2507,China
234,2020-10,1987,1236,3223,China
235,2020-11,2220,1423,3643,China
236,2020-12,2257,1417,3674,China
237,2021-01,1922,1284,3206,China
238,2019-12,8702,43229,51931,Italy
239,2020-01,8681,41519,50200,Italy
240,2020-02,10022,43090,53112,Italy
241,2020-03,4403,16428,20831,Italy
242,2020-04,2159,2780,4939,Italy
243,2020-05,3636,3403,7039,Italy
244,2020-06,6166,7386,13552,Italy
245,2020-07,10374,20003,30377,Italy
246,2020-08,11831,27068,38899,Italy
247,2020-09,11470,23162,34632,Italy
248,2020-10,10842,20223,31065,Italy
249,2020-11,7750,10771,18521,Italy
250,2020-12,5139,10351,15490,Italy
251,2021-01,4876,8994,13870,Italy
252,2019-12,3320,14384,17704,Sweden
253,2020-01,3412,14038,17450,Sweden
254,2020-02,3962,14262,18224,Sweden
255,2020-03,3656,10088,13744,Sweden
256,2020-04,1867,1652,3519,Sweden
257,2020-05,1926,1994,3920,Sweden
258,2020-06,2657,2647,5304,Sweden
259,2020-07,2497,4393,6890,Sweden
260,2020-08,3132,5391,8523,Sweden
261,2020-09,2619,5766,8385,Sweden
262,2020-10,2361,6069,8430,Sweden
263,2020-11,2129,4473,6602,Sweden
264,2020-12,1456,4505,5961,Sweden
265,2021-01,1576,3899,5475,Sweden
266,2019-12,1856,11591,13447,Turkey
267,2020-01,2310,12259,14569,Turkey
268,2020-02,2303,10626,12929,Turkey
269,2020-03,1563,6144,7707,Turkey
270,2020-04,320,1747,2067,Turkey
271,2020-05,355,2322,2677,Turkey
272,2020-06,843,3118,3961,Turkey
273,2020-07,1775,7348,9123,Turkey
274,2020-08,3614,15001,18615,Turkey
275,2020-09,4602,15568,20170,Turkey
276,2020-10,3923,13906,17829,Turkey
277,2020-11,3223,9089,12312,Turkey
278,2020-12,1538,6876,8414,Turkey
279,2021-01,1612,9746,11358,Turkey
280,2019-12,1631,17743,19374,Poland
281,2020-01,1757,18585,20342,Poland
282,2020-02,2087,18027,20114,Poland
283,2020-03,1752,9775,11527,Poland
284,2020-04,1111,823,1934,Poland
285,2020-05,1918,894,2812,Poland
286,2020-06,2647,2199,4846,Poland
287,2020-07,3574,9941,13515,Poland
288,2020-08,3853,12849,16702,Poland
289,2020-09,3979,11836,15815,Poland
290,2020-10,3077,10140,13217,Poland
291,2020-11,2155,6089,8244,Poland
292,2020-12,1648,6200,7848,Poland
293,2021-01,1417,5396,6813,Poland
294,2019-12,350,13954,14304,Thailand
295,2020-01,356,14304,14660,Thailand
296,2020-02,338,13164,13502,Thailand
297,2020-03,208,7627,7835,Thailand
298,2020-04,50,1894,1944,Thailand
299,2020-05,45,1079,1124,Thailand
300,2020-06,20,992,1012,Thailand
301,2020-07,32,1521,1553,Thailand
302,2020-08,23,2523,2546,Thailand
303,2020-09,32,2150,2182,Thailand
304,2020-10,2,17,19,Thailand
305,2020-11,17,66,83,Thailand
306,2020-12,22,106,128,Thailand
307,2021-01,51,1971,2022,Thailand
308,2019-12,8934,43190,52124,Spain
309,2020-01,6617,37207,43824,Spain
310,2020-02,9342,44716,54058,Spain
311,2020-03,5929,30099,36028,Spain
312,2020-04,895,2598,3493,Spain
313,2020-05,1226,2991,4217,Spain
314,2020-06,2804,5420,8224,Spain
315,2020-07,9239,29964,39203,Spain
316,2020-08,10414,40202,50616,Spain
317,2020-09,7427,25675,33102,Spain
318,2020-10,6496,20084,26580,Spain
319,2020-11,4317,11231,15548,Spain
320,2020-12,3987,12146,16133,Spain
321,2021-01,3519,10136,13655,Spain
322,2019-12,2102,14319,16421,"Taiwan, Province of China"
323,2020-01,917,14050,14967,"Taiwan, Province of China"
324,2020-02,1392,10362,11754,"Taiwan, Province of China"
325,2020-03,1404,5699,7103,"Taiwan, Province of China"
326,2020-04,1339,3845,5184,"Taiwan, Province of China"
327,2020-05,1298,4630,5928,"Taiwan, Province of China"
328,2020-06,1628,4708,6336,"Taiwan, Province of China"
329,2020-07,2644,5024,7668,"Taiwan, Province of China"
330,2020-08,2192,5312,7504,"Taiwan, Province of China"
331,2020-09,749,5624,6373,"Taiwan, Province of China"
332,2020-10,1213,5904,7117,"Taiwan, Province of China"
333,2020-11,1053,6136,7189,"Taiwan, Province of China"
334,2020-12,2066,6641,8707,"Taiwan, Province of China"
335,2021-01,2977,5994,8971,"Taiwan, Province of China"
336,2019-12,1901,26445,28346,Switzerland
337,2020-01,2347,26750,29097,Switzerland
338,2020-02,2439,27841,30280,Switzerland
339,2020-03,2181,17062,19243,Switzerland
340,2020-04,1554,1591,3145,Switzerland
341,2020-05,3715,2711,6426,Switzerland
342,2020-06,4159,6278,10437,Switzerland
343,2020-07,5544,12269,17813,Switzerland
344,2020-08,4698,13932,18630,Switzerland
345,2020-09,4652,12164,16816,Switzerland
346,2020-10,3858,10741,14599,Switzerland
347,2020-11,3286,6857,10143,Switzerland
348,2020-12,1906,8648,10554,Switzerland
349,2021-01,2076,7817,9893,Switzerland
350,2019-12,14590,88761,103351,United Kingdom
351,2020-01,15746,86435,102181,United Kingdom
352,2020-02,15562,89573,105135,United Kingdom
353,2020-03,14875,64832,79707,United Kingdom
354,2020-04,3902,8520,12422,United Kingdom
355,2020-05,7870,10850,18720,United Kingdom
356,2020-06,10477,13993,24470,United Kingdom
357,2020-07,15900,34333,50233,United Kingdom
358,2020-08,16787,50687,67474,United Kingdom
359,2020-09,19741,45946,65687,United Kingdom
360,2020-10,17430,39787,57217,United Kingdom
361,2020-11,11012,22290,33302,United Kingdom
362,2020-12,13015,25001,38016,United Kingdom
363,2021-01,8034,17958,25992,United Kingdom
364,2019-12,423,16897,17320,Ireland
365,2020-01,432,16648,17080,Ireland
366,2020-02,482,16310,16792,Ireland
367,2020-03,556,13580,14136,Ireland
368,2020-04,475,1768,2243,Ireland
369,2020-05,465,1863,2328,Ireland
370,2020-06,533,2269,2802,Ireland
371,2020-07,723,6317,7040,Ireland
372,2020-08,704,8025,8729,Ireland
373,2020-09,817,6582,7399,Ireland
374,2020-10,740,5409,6149,Ireland
375,2020-11,639,3500,4139,Ireland
376,2020-12,641,3750,4391,Ireland
377,2021-01,688,3375,4063,Ireland
378,2019-12,47,4530,4577,Luxembourg
379,2020-01,45,4601,4646,Luxembourg
380,2020-02,37,4665,4702,Luxembourg
381,2020-03,54,3246,3300,Luxembourg
382,2020-04,49,857,906,Luxembourg
383,2020-05,79,1046,1125,Luxembourg
384,2020-06,63,1759,1822,Luxembourg
385,2020-07,56,2766,2822,Luxembourg
386,2020-08,19,2735,2754,Luxembourg
387,2020-09,25,2677,2702,Luxembourg
388,2020-10,15,2646,2661,Luxembourg
389,2020-11,13,2197,2210,Luxembourg
390,2020-12,16,2247,2263,Luxembourg
391,2021-01,11,2028,2039,Luxembourg
392,2019-12,541,16915,17456,Belgium
393,2020-01,462,16272,16734,Belgium
394,2020-02,500,16650,17150,Belgium
395,2020-03,429,11957,12386,Belgium
396,2020-04,173,3552,3725,Belgium
397,2020-05,695,4444,5139,Belgium
398,2020-06,882,5913,6795,Belgium
399,2020-07,835,10401,11236,Belgium
400,2020-08,715,11174,11889,Belgium
401,2020-09,926,9899,10825,Belgium
402,2020-10,751,9406,10157,Belgium
403,2020-11,572,7626,8198,Belgium
404,2020-12,428,8248,8676,Belgium
405,2021-01,378,7029,7407,Belgium
406,2019-12,12506,4452,16958,Brazil
407,2020-01,12293,4451,16744,Brazil
408,2020-02,13895,5978,19873,Brazil
409,2020-03,10587,4545,15132,Brazil
410,2020-04,2114,799,2913,Brazil
411,2020-05,2290,1020,3310,Brazil
412,2020-06,2810,1112,3922,Brazil
413,2020-07,3477,1192,4669,Brazil
414,2020-08,3977,1397,5374,Brazil
415,2020-09,6541,1601,8142,Brazil
416,2020-10,9154,1875,11029,Brazil
417,2020-11,7281,1972,9253,Brazil
418,2020-12,9159,2344,11503,Brazil
419,2021-01,10490,2220,12710,Brazil
420,2019-12,31,2881,2912,Iceland
421,2020-01,20,2303,2323,Iceland
422,2020-02,67,2588,2655,Iceland
423,2020-03,92,2026,2118,Iceland
424,2020-04,26,377,403,Iceland
425,2020-05,79,528,607,Iceland
426,2020-06,78,710,788,Iceland
427,2020-07,46,1176,1222,Iceland
428,2020-08,15,841,856,Iceland
429,2020-09,18,647,665,Iceland
430,2020-10,25,745,770,Iceland
431,2020-11,30,585,615,Iceland
432,2020-12,52,614,666,Iceland
433,2021-01,52,451,503,Iceland
434,2019-12,1927,15121,17048,Denmark
435,2020-01,1789,15263,17052,Denmark
436,2020-02,1785,16113,17898,Denmark
437,2020-03,1650,10179,11829,Denmark
438,2020-04,943,1244,2187,Denmark
439,2020-05,1370,1525,2895,Denmark
440,2020-06,1981,2918,4899,Denmark
441,2020-07,2330,6592,8922,Denmark
442,2020-08,2580,7561,10141,Denmark
443,2020-09,2291,7500,9791,Denmark
444,2020-10,2108,6711,8819,Denmark
445,2020-11,1655,4188,5843,Denmark
446,2020-12,1221,4148,5369,Denmark
447,2021-01,1356,3377,4733,Denmark
448,2019-12,2027,9380,11407,Finland
449,2020-01,2324,9352,11676,Finland
450,2020-02,2216,8000,10216,Finland
451,2020-03,1654,5518,7172,Finland
452,2020-04,602,985,1587,Finland
453,2020-05,921,1330,2251,Finland
454,2020-06,1100,2036,3136,Finland
455,2020-07,1137,3156,4293,Finland
456,2020-08,1425,3822,5247,Finland
457,2020-09,1153,2876,4029,Finland
458,2020-10,995,2536,3531,Finland
459,2020-11,932,2348,3280,Finland
460,2020-12,692,2434,3126,Finland
461,2021-01,773,2285,3058,Finland
462,2019-12,1135,5619,6754,Greece
463,2020-01,1011,5194,6205,Greece
464,2020-02,1135,4749,5884,Greece
465,2020-03,1029,3729,4758,Greece
466,2020-04,357,571,928,Greece
467,2020-05,413,660,1073,Greece
468,2020-06,1187,1541,2728,Greece
469,2020-07,2116,7603,9719,Greece
470,2020-08,843,10607,11450,Greece
471,2020-09,463,7804,8267,Greece
472,2020-10,456,7380,7836,Greece
473,2020-11,233,1928,2161,Greece
474,2020-12,116,963,1079,Greece
475,2021-01,164,743,907,Greece
476,2019-12,43,7445,7488,Hungary
477,2020-01,29,6992,7021,Hungary
478,2020-02,109,7155,7264,Hungary
479,2020-03,97,4903,5000,Hungary
480,2020-04,95,728,823,Hungary
481,2020-05,103,909,1012,Hungary
482,2020-06,126,1875,2001,Hungary
483,2020-07,109,3417,3526,Hungary
484,2020-08,87,3973,4060,Hungary
485,2020-09,111,2296,2407,Hungary
486,2020-10,89,1893,1982,Hungary
487,2020-11,84,1450,1534,Hungary
488,2020-12,85,1529,1614,Hungary
489,2021-01,97,1389,1486,Hungary
490,2019-12,621,8333,8954,Czech Republic
491,2020-01,488,7569,8057,Czech Republic
492,2020-02,565,7517,8082,Czech Republic
493,2020-03,622,4628,5250,Czech Republic
494,2020-04,1216,597,1813,Czech Republic
495,2020-05,1286,916,2202,Czech Republic
496,2020-06,1246,1779,3025,Czech Republic
497,2020-07,1595,3600,5195,Czech Republic
498,2020-08,1764,3934,5698,Czech Republic
499,2020-09,1932,3988,5920,Czech Republic
500,2020-10,1356,2689,4045,Czech Republic
501,2020-11,1267,1851,3118,Czech Republic
502,2020-12,1028,2227,3255,Czech Republic
503,2021-01,905,1874,2779,Czech Republic
504,2019-12,4182,9918,14100,Norway
505,2020-01,4031,9391,13422,Norway
506,2020-02,3887,9750,13637,Norway
507,2020-03,3783,6531,10314,Norway
508,2020-04,2053,827,2880,Norway
509,2020-05,2759,1025,3784,Norway
510,2020-06,3257,1953,5210,Norway
511,2020-07,4169,4373,8542,Norway
512,2020-08,5550,5260,10810,Norway
513,2020-09,6852,4406,11258,Norway
514,2020-10,5452,3716,9168,Norway
515,2020-11,4762,2601,7363,Norway
516,2020-12,4343,2638,6981,Norway
517,2021-01,5875,2422,8297,Norway
518,2019-12,1801,17092,18893,Portugal
519,2020-01,1632,16409,18041,Portugal
520,2020-02,2104,17471,19575,Portugal
521,2020-03,1281,11986,13267,Portugal
522,2020-04,258,679,937,Portugal
523,2020-05,580,1086,1666,Portugal
524,2020-06,925,2654,3579,Portugal
525,2020-07,1657,9350,11007,Portugal
526,2020-08,2288,14131,16419,Portugal
527,2020-09,2159,12269,14428,Portugal
528,2020-10,2283,10451,12734,Portugal
529,2020-11,2126,5648,7774,Portugal
530,2020-12,1646,6421,8067,Portugal
531,2021-01,1489,4972,6461,Portugal
532,2019-12,88,2397,2485,Costa Rica
533,2020-01,85,2489,2574,Costa Rica
534,2020-02,69,2473,2542,Costa Rica
535,2020-03,52,2016,2068,Costa Rica
536,2020-04,10,196,206,Costa Rica
537,2020-05,33,284,317,Costa Rica
538,2020-06,44,326,370,Costa Rica
539,2020-07,28,291,319,Costa Rica
540,2020-08,32,367,399,Costa Rica
541,2020-09,10,431,441,Costa Rica
542,2020-10,16,606,622,Costa Rica
543,2020-11,12,883,895,Costa Rica
544,2020-12,14,1340,1354,Costa Rica
545,2021-01,28,1597,1625,Costa Rica
546,2019-12,740,17404,18144,Austria
547,2020-01,618,17308,17926,Austria
548,2020-02,945,18105,19050,Austria
549,2020-03,656,10312,10968,Austria
550,2020-04,346,1156,1502,Austria
551,2020-05,1584,1652,3236,Austria
552,2020-06,1828,3792,5620,Austria
553,2020-07,1886,7957,9843,Austria
554,2020-08,1723,9804,11527,Austria
555,2020-09,1911,9151,11062,Austria
556,2020-10,1529,7004,8533,Austria
557,2020-11,956,4180,5136,Austria
558,2020-12,858,4068,4926,Austria
559,2021-01,825,3484,4309,Austria
560,2019-12,37,3586,3623,Bahrain
561,2020-01,54,3657,3711,Bahrain
562,2020-02,52,3293,3345,Bahrain
563,2020-03,58,1876,1934,Bahrain
564,2020-04,64,814,878,Bahrain
565,2020-05,57,861,918,Bahrain
566,2020-06,78,985,1063,Bahrain
567,2020-07,54,1098,1152,Bahrain
568,2020-08,44,1096,1140,Bahrain
569,2020-09,57,1121,1178,Bahrain
570,2020-10,42,1184,1226,Bahrain
571,2020-11,54,1344,1398,Bahrain
572,2020-12,70,1584,1654,Bahrain
573,2021-01,41,1555,1596,Bahrain
574,2019-12,122,887,1009,Senegal
575,2020-01,126,813,939,Senegal
576,2020-02,106,806,912,Senegal
577,2020-03,94,594,688,Senegal
578,2020-04,25,200,225,Senegal
579,2020-05,35,218,253,Senegal
580,2020-06,38,325,363,Senegal
581,2020-07,21,360,381,Senegal
582,2020-08,0,0,0,Senegal
583,2020-09,0,0,0,Senegal
584,2020-10,0,0,0,Senegal
585,2020-11,0,0,0,Senegal
586,2020-12,0,0,0,Senegal
587,2021-01,15,131,146,Senegal
588,2019-12,1421,4151,5572,Saudi Arabia
589,2020-01,867,4001,4868,Saudi Arabia
590,2020-02,1228,3607,4835,Saudi Arabia
591,2020-03,1206,1703,2909,Saudi Arabia
592,2020-04,471,639,1110,Saudi Arabia
593,2020-05,297,890,1187,Saudi Arabia
594,2020-06,876,1201,2077,Saudi Arabia
595,2020-07,770,1120,1890,Saudi Arabia
596,2020-08,618,812,1430,Saudi Arabia
597,2020-09,708,864,1572,Saudi Arabia
598,2020-10,521,1068,1589,Saudi Arabia
599,2020-11,312,1082,1394,Saudi Arabia
600,2020-12,335,995,1330,Saudi Arabia
601,2021-01,444,1232,1676,Saudi Arabia
602,2019-12,200,1360,1560,Kazakhstan
603,2020-01,156,1411,1567,Kazakhstan
604,2020-02,130,1240,1370,Kazakhstan
605,2020-03,115,1012,1127,Kazakhstan
606,2020-04,13,617,630,Kazakhstan
607,2020-05,88,848,936,Kazakhstan
608,2020-06,183,467,650,Kazakhstan
609,2020-07,76,416,492,Kazakhstan
610,2020-08,37,98,135,Kazakhstan
611,2020-09,20,30,50,Kazakhstan
612,2020-10,78,136,214,Kazakhstan
613,2020-11,306,596,902,Kazakhstan
614,2020-12,308,588,896,Kazakhstan
615,2021-01,362,607,969,Kazakhstan
616,2019-12,36,1547,1583,Morocco
617,2020-01,70,2642,2712,Morocco
618,2020-02,86,2714,2800,Morocco
619,2020-03,51,1425,1476,Morocco
620,2020-04,18,167,185,Morocco
621,2020-05,14,322,336,Morocco
622,2020-06,46,406,452,Morocco
623,2020-07,84,988,1072,Morocco
624,2020-08,75,1343,1418,Morocco
625,2020-09,106,1216,1322,Morocco
626,2020-10,118,1492,1610,Morocco
627,2020-11,107,1442,1549,Morocco
628,2020-12,69,2066,2135,Morocco
629,2021-01,48,1948,1996,Morocco
630,2019-12,28,4545,4573,Ukraine
631,2020-01,28,4645,4673,Ukraine
632,2020-02,31,4470,4501,Ukraine
633,2020-03,28,2814,2842,Ukraine
634,2020-04,26,315,341,Ukraine
635,2020-05,47,779,826,Ukraine
636,2020-06,72,964,1036,Ukraine
637,2020-07,154,2634,2788,Ukraine
638,2020-08,184,3833,4017,Ukraine
639,2020-09,302,4006,4308,Ukraine
640,2020-10,317,5649,5966,Ukraine
641,2020-11,268,3569,3837,Ukraine
642,2020-12,286,3544,3830,Ukraine
643,2021-01,291,3256,3547,Ukraine
644,2019-12,0,657,657,Ecuador
645,2020-01,2,854,856,Ecuador
646,2020-02,0,293,293,Ecuador
647,2020-03,0,0,0,Ecuador
648,2020-04,0,0,0,Ecuador
649,2020-05,0,0,0,Ecuador
650,2020-06,5,180,185,Ecuador
651,2020-07,0,111,111,Ecuador
652,2020-08,1,223,224,Ecuador
653,2020-09,0,149,149,Ecuador
654,2020-10,0,150,150,Ecuador
655,2020-11,0,300,300,Ecuador
656,2020-12,2,453,455,Ecuador
657,2021-01,0,543,543,Ecuador
658,2019-12,0,83,83,Uzbekistan
659,2020-01,0,35,35,Uzbekistan
660,2020-02,0,21,21,Uzbekistan
661,2020-03,0,26,26,Uzbekistan
662,2020-04,0,1,1,Uzbekistan
663,2020-05,0,11,11,Uzbekistan
664,2020-06,0,9,9,Uzbekistan
665,2020-07,0,3,3,Uzbekistan
666,2020-08,0,10,10,Uzbekistan
667,2020-09,0,69,69,Uzbekistan
668,2020-10,0,107,107,Uzbekistan
669,2020-11,0,94,94,Uzbekistan
670,2020-12,0,104,104,Uzbekistan
671,2021-01,0,75,75,Uzbekistan
672,2019-12,0,320,320,Gambia
673,2020-01,0,333,333,Gambia
674,2020-02,0,347,347,Gambia
675,2020-03,0,261,261,Gambia
676,2020-04,0,18,18,Gambia
677,2020-05,0,10,10,Gambia
678,2020-06,0,13,13,Gambia
679,2020-07,0,17,17,Gambia
680,2020-08,0,0,0,Gambia
681,2020-09,0,0,0,Gambia
682,2020-10,0,0,0,Gambia
683,2020-11,0,0,0,Gambia
684,2020-12,0,0,0,Gambia
685,2021-01,0,27,27,Gambia
686,2019-12,29,2220,2249,Lebanon
687,2020-01,27,2259,2286,Lebanon
688,2020-02,7,474,481,Lebanon
689,2020-03,0,0,0,Lebanon
690,2020-04,0,0,0,Lebanon
691,2020-05,1,79,80,Lebanon
692,2020-06,5,217,222,Lebanon
693,2020-07,0,291,291,Lebanon
694,2020-08,1,514,515,Lebanon
695,2020-09,1,1001,1002,Lebanon
696,2020-10,6,1210,1216,Lebanon
697,2020-11,15,1237,1252,Lebanon
698,2020-12,7,1416,1423,Lebanon
699,2021-01,12,1400,1412,Lebanon
700,2019-12,22,2588,2610,Serbia
701,2020-01,16,1574,1590,Serbia
702,2020-02,20,1948,1968,Serbia
703,2020-03,16,1531,1547,Serbia
704,2020-04,4,156,160,Serbia
705,2020-05,11,411,422,Serbia
706,2020-06,19,1095,1114,Serbia
707,2020-07,22,1649,1671,Serbia
708,2020-08,20,1221,1241,Serbia
709,2020-09,13,1219,1232,Serbia
710,2020-10,11,1730,1741,Serbia
711,2020-11,10,1231,1241,Serbia
712,2020-12,26,1057,1083,Serbia
713,2021-01,21,1096,1117,Serbia
714,2019-12,120,5194,5314,Latvia
715,2020-01,93,5179,5272,Latvia
716,2020-02,123,4795,4918,Latvia
717,2020-03,124,2941,3065,Latvia
718,2020-04,61,193,254,Latvia
719,2020-05,110,425,535,Latvia
720,2020-06,160,1226,1386,Latvia
721,2020-07,198,2615,2813,Latvia
722,2020-08,299,2778,3077,Latvia
723,2020-09,159,2814,2973,Latvia
724,2020-10,118,2207,2325,Latvia
725,2020-11,84,1539,1623,Latvia
726,2020-12,29,1761,1790,Latvia
727,2021-01,14,1387,1401,Latvia
728,2019-12,3,162,165,Mali
729,2020-01,2,96,98,Mali
730,2020-02,0,15,15,Mali
731,2020-03,0,0,0,Mali
732,2020-04,0,0,0,Mali
733,2020-05,0,0,0,Mali
734,2020-06,0,0,0,Mali
735,2020-07,0,0,0,Mali
736,2020-08,0,0,0,Mali
737,2020-09,0,0,0,Mali
738,2020-10,0,0,0,Mali
739,2020-11,0,0,0,Mali
740,2020-12,0,0,0,Mali
741,2021-01,0,0,0,Mali
742,2019-12,9,1170,1179,Armenia
743,2020-01,12,1241,1253,Armenia
744,2020-02,14,1115,1129,Armenia
745,2020-03,6,789,795,Armenia
746,2020-04,2,111,113,Armenia
747,2020-05,3,122,125,Armenia
748,2020-06,4,97,101,Armenia
749,2020-07,0,0,0,Armenia
750,2020-08,0,0,0,Armenia
751,2020-09,0,0,0,Armenia
752,2020-10,0,0,0,Armenia
753,2020-11,0,0,0,Armenia
754,2020-12,0,0,0,Armenia
755,2021-01,0,0,0,Armenia
756,2019-12,30,2597,2627,Malta
757,2020-01,83,2455,2538,Malta
758,2020-02,95,2547,2642,Malta
759,2020-03,75,1615,1690,Malta
760,2020-04,43,224,267,Malta
761,2020-05,49,247,296,Malta
762,2020-06,104,300,404,Malta
763,2020-07,101,1551,1652,Malta
764,2020-08,76,2426,2502,Malta
765,2020-09,59,1962,2021,Malta
766,2020-10,58,1668,1726,Malta
767,2020-11,100,1013,1113,Malta
768,2020-12,88,850,938,Malta
769,2021-01,80,761,841,Malta
770,2019-12,1,181,182,Cape Verde
771,2020-01,0,88,88,Cape Verde
772,2020-02,1,106,107,Cape Verde
773,2020-03,0,90,90,Cape Verde
774,2020-04,0,24,24,Cape Verde
775,2020-05,1,30,31,Cape Verde
776,2020-06,0,10,10,Cape Verde
777,2020-07,0,0,0,Cape Verde
778,2020-08,0,0,0,Cape Verde
779,2020-09,0,0,0,Cape Verde
780,2020-10,0,0,0,Cape Verde
781,2020-11,0,0,0,Cape Verde
782,2020-12,0,0,0,Cape Verde
783,2021-01,0,17,17,Cape Verde
784,2019-12,43,1915,1958,Estonia
785,2020-01,34,1943,1977,Estonia
786,2020-02,64,1920,1984,Estonia
787,2020-03,85,1276,1361,Estonia
788,2020-04,89,244,333,Estonia
789,2020-05,144,410,554,Estonia
790,2020-06,151,788,939,Estonia
791,2020-07,173,1198,1371,Estonia
792,2020-08,103,1221,1324,Estonia
793,2020-09,110,1134,1244,Estonia
794,2020-10,125,955,1080,Estonia
795,2020-11,95,839,934,Estonia
796,2020-12,82,844,926,Estonia
797,2021-01,68,763,831,Estonia
798,2019-12,7,1390,1397,Lithuania
799,2020-01,15,1231,1246,Lithuania
800,2020-02,2,678,680,Lithuania
801,2020-03,20,878,898,Lithuania
802,2020-04,50,331,381,Lithuania
803,2020-05,164,455,619,Lithuania
804,2020-06,285,1087,1372,Lithuania
805,2020-07,294,2206,2500,Lithuania
806,2020-08,366,2799,3165,Lithuania
807,2020-09,424,2451,2875,Lithuania
808,2020-10,238,1922,2160,Lithuania
809,2020-11,121,1317,1438,Lithuania
810,2020-12,68,1270,1338,Lithuania
811,2021-01,49,1258,1307,Lithuania
812,2019-12,13,1657,1670,Romania
813,2020-01,20,2090,2110,Romania
814,2020-02,21,2391,2412,Romania
815,2020-03,134,3940,4074,Romania
816,2020-04,52,550,602,Romania
817,2020-05,58,575,633,Romania
818,2020-06,152,1194,1346,Romania
819,2020-07,210,3316,3526,Romania
820,2020-08,318,4250,4568,Romania
821,2020-09,232,3368,3600,Romania
822,2020-10,219,3300,3519,Romania
823,2020-11,272,1981,2253,Romania
824,2020-12,82,2098,2180,Romania
825,2021-01,77,2173,2250,Romania
826,2019-12,212,2133,2345,Croatia
827,2020-01,255,2110,2365,Croatia
828,2020-02,238,2063,2301,Croatia
829,2020-03,186,1661,1847,Croatia
830,2020-04,29,275,304,Croatia
831,2020-05,188,408,596,Croatia
832,2020-06,362,1469,1831,Croatia
833,2020-07,325,2602,2927,Croatia
834,2020-08,259,2647,2906,Croatia
835,2020-09,234,1650,1884,Croatia
836,2020-10,131,1235,1366,Croatia
837,2020-11,92,888,980,Croatia
838,2020-12,35,747,782,Croatia
839,2021-01,23,719,742,Croatia
840,2019-12,120,879,999,Slovenia
841,2020-01,156,832,988,Slovenia
842,2020-02,145,920,1065,Slovenia
843,2020-03,104,670,774,Slovenia
844,2020-04,109,190,299,Slovenia
845,2020-05,207,241,448,Slovenia
846,2020-06,303,624,927,Slovenia
847,2020-07,318,660,978,Slovenia
848,2020-08,324,758,1082,Slovenia
849,2020-09,340,718,1058,Slovenia
850,2020-10,174,577,751,Slovenia
851,2020-11,151,372,523,Slovenia
852,2020-12,68,353,421,Slovenia
853,2021-01,107,322,429,Slovenia
854,2019-12,41,5050,5091,Israel
855,2020-01,67,5679,5746,Israel
856,2020-02,35,4781,4816,Israel
857,2020-03,9,1835,1844,Israel
858,2020-04,3,480,483,Israel
859,2020-05,107,1210,1317,Israel
860,2020-06,187,1280,1467,Israel
861,2020-07,119,1590,1709,Israel
862,2020-08,56,1539,1595,Israel
863,2020-09,281,1943,2224,Israel
864,2020-10,272,2514,2786,Israel
865,2020-11,225,2263,2488,Israel
866,2020-12,238,2645,2883,Israel
867,2021-01,155,1770,1925,Israel
868,2019-12,0,14,14,Mauritania
869,2020-01,0,0,0,Mauritania
870,2020-02,0,14,14,Mauritania
871,2020-03,0,16,16,Mauritania
872,2020-04,1,4,5,Mauritania
873,2020-05,0,0,0,Mauritania
874,2020-06,0,1,1,Mauritania
875,2020-07,0,0,0,Mauritania
876,2020-08,0,0,0,Mauritania
877,2020-09,0,0,0,Mauritania
878,2020-10,0,0,0,Mauritania
879,2020-11,0,0,0,Mauritania
880,2020-12,0,0,0,Mauritania
881,2021-01,0,0,0,Mauritania
882,2019-12,391,3576,3967,Colombia
883,2020-01,358,3982,4340,Colombia
884,2020-02,388,3821,4209,Colombia
885,2020-03,279,2710,2989,Colombia
886,2020-04,110,878,988,Colombia
887,2020-05,86,1106,1192,Colombia
888,2020-06,164,941,1105,Colombia
889,2020-07,201,1005,1206,Colombia
890,2020-08,257,992,1249,Colombia
891,2020-09,441,1076,1517,Colombia
892,2020-10,471,1573,2044,Colombia
893,2020-11,548,1840,2388,Colombia
894,2020-12,579,2461,3040,Colombia
895,2021-01,732,2660,3392,Colombia
896,2019-12,6,942,948,Belarus
897,2020-01,15,2248,2263,Belarus
898,2020-02,46,2641,2687,Belarus
899,2020-03,27,2022,2049,Belarus
900,2020-04,3,454,457,Belarus
901,2020-05,7,605,612,Belarus
902,2020-06,20,848,868,Belarus
903,2020-07,17,1243,1260,Belarus
904,2020-08,36,1359,1395,Belarus
905,2020-09,21,1409,1430,Belarus
906,2020-10,13,1268,1281,Belarus
907,2020-11,7,1064,1071,Belarus
908,2020-12,11,1072,1083,Belarus
909,2021-01,5,1177,1182,Belarus
910,2019-12,15,1457,1472,Algeria
911,2020-01,55,2340,2395,Algeria
912,2020-02,42,1927,1969,Algeria
913,2020-03,25,1166,1191,Algeria
914,2020-04,22,95,117,Algeria
915,2020-05,38,194,232,Algeria
916,2020-06,48,248,296,Algeria
917,2020-07,72,394,466,Algeria
918,2020-08,49,335,384,Algeria
919,2020-09,30,268,298,Algeria
920,2020-10,8,178,186,Algeria
921,2020-11,10,88,98,Algeria
922,2020-12,4,73,77,Algeria
923,2021-01,15,179,194,Algeria
924,2019-12,230,1941,2171,Argentina
925,2020-01,254,2024,2278,Argentina
926,2020-02,463,3067,3530,Argentina
927,2020-03,137,1446,1583,Argentina
928,2020-04,59,253,312,Argentina
929,2020-05,91,374,465,Argentina
930,2020-06,159,393,552,Argentina
931,2020-07,150,366,516,Argentina
932,2020-08,182,419,601,Argentina
933,2020-09,159,392,551,Argentina
934,2020-10,0,0,0,Argentina
935,2020-11,0,0,0,Argentina
936,2020-12,0,0,0,Argentina
937,2021-01,0,0,0,Argentina
938,2019-12,5,1836,1841,Dominican Republic
939,2020-01,4,2775,2779,Dominican Republic
940,2020-02,5,3146,3151,Dominican Republic
941,2020-03,4,2488,2492,Dominican Republic
942,2020-04,1,36,37,Dominican Republic
943,2020-05,0,0,0,Dominican Republic
944,2020-06,0,0,0,Dominican Republic
945,2020-07,0,0,0,Dominican Republic
946,2020-08,0,0,0,Dominican Republic
947,2020-09,103,584,687,Dominican Republic
948,2020-10,18,112,130,Dominican Republic
949,2020-11,0,0,0,Dominican Republic
950,2020-12,0,0,0,Dominican Republic
951,2021-01,0,0,0,Dominican Republic
952,2019-12,1,366,367,Saint Lucia
953,2020-01,1,217,218,Saint Lucia
954,2020-02,0,376,376,Saint Lucia
955,2020-03,1,334,335,Saint Lucia
956,2020-04,0,2,2,Saint Lucia
957,2020-05,0,2,2,Saint Lucia
958,2020-06,0,0,0,Saint Lucia
959,2020-07,0,1,1,Saint Lucia
960,2020-08,0,3,3,Saint Lucia
961,2020-09,0,13,13,Saint Lucia
962,2020-10,0,105,105,Saint Lucia
963,2020-11,1,132,133,Saint Lucia
964,2020-12,0,208,208,Saint Lucia
965,2021-01,0,26,26,Saint Lucia
966,2019-12,5,1099,1104,Barbados
967,2020-01,3,740,743,Barbados
968,2020-02,3,1220,1223,Barbados
969,2020-03,4,1133,1137,Barbados
970,2020-04,0,26,26,Barbados
971,2020-05,1,57,58,Barbados
972,2020-06,1,69,70,Barbados
973,2020-07,0,49,49,Barbados
974,2020-08,0,65,65,Barbados
975,2020-09,3,136,139,Barbados
976,2020-10,1,334,335,Barbados
977,2020-11,1,367,368,Barbados
978,2020-12,0,610,610,Barbados
979,2021-01,0,52,52,Barbados
980,2019-12,4,530,534,Isle of Man
981,2020-01,3,629,632,Isle of Man
982,2020-02,2,627,629,Isle of Man
983,2020-03,5,417,422,Isle of Man
984,2020-04,1,17,18,Isle of Man
985,2020-05,5,33,38,Isle of Man
986,2020-06,8,151,159,Isle of Man
987,2020-07,7,132,139,Isle of Man
988,2020-08,7,134,141,Isle of Man
989,2020-09,5,142,147,Isle of Man
990,2020-10,3,148,151,Isle of Man
991,2020-11,7,129,136,Isle of Man
992,2020-12,10,135,145,Isle of Man
993,2021-01,7,86,93,Isle of Man
994,2019-12,23,747,770,Bermuda
995,2020-01,6,700,706,Bermuda
996,2020-02,0,758,758,Bermuda
997,2020-03,1,511,512,Bermuda
998,2020-04,0,91,91,Bermuda
999,2020-05,0,117,117,Bermuda
1000,2020-06,0,163,163,Bermuda
1001,2020-07,1,340,341,Bermuda
1002,2020-08,0,425,425,Bermuda
1003,2020-09,0,383,383,Bermuda
1004,2020-10,0,525,525,Bermuda
1005,2020-11,2,464,466,Bermuda
1006,2020-12,0,477,477,Bermuda
1007,2021-01,0,362,362,Bermuda
1008,2019-12,2,300,302,Jersey
1009,2020-01,0,292,292,Jersey
1010,2020-02,0,252,252,Jersey
1011,2020-03,0,192,192,Jersey
1012,2020-04,0,43,43,Jersey
1013,2020-05,14,142,156,Jersey
1014,2020-06,23,249,272,Jersey
1015,2020-07,23,587,610,Jersey
1016,2020-08,23,975,998,Jersey
1017,2020-09,32,900,932,Jersey
1018,2020-10,31,746,777,Jersey
1019,2020-11,35,457,492,Jersey
1020,2020-12,23,464,487,Jersey
1021,2021-01,23,258,281,Jersey
1022,2019-12,3,663,666,Guernsey
1023,2020-01,1,627,628,Guernsey
1024,2020-02,1,667,668,Guernsey
1025,2020-03,1,587,588,Guernsey
1026,2020-04,0,96,96,Guernsey
1027,2020-05,35,143,178,Guernsey
1028,2020-06,38,150,188,Guernsey
1029,2020-07,87,149,236,Guernsey
1030,2020-08,69,266,335,Guernsey
1031,2020-09,66,260,326,Guernsey
1032,2020-10,39,297,336,Guernsey
1033,2020-11,88,194,282,Guernsey
1034,2020-12,47,241,288,Guernsey
1035,2021-01,29,180,209,Guernsey
1036,2019-12,0,118,118,Cyprus
1037,2020-01,0,66,66,Cyprus
1038,2020-02,0,7,7,Cyprus
1039,2020-03,1,21,22,Cyprus
1040,2020-04,1,252,253,Cyprus
1041,2020-05,17,311,328,Cyprus
1042,2020-06,51,587,638,Cyprus
1043,2020-07,21,1820,1841,Cyprus
1044,2020-08,17,2408,2425,Cyprus
1045,2020-09,48,2482,2530,Cyprus
1046,2020-10,52,2513,2565,Cyprus
1047,2020-11,49,1220,1269,Cyprus
1048,2020-12,46,935,981,Cyprus
1049,2021-01,53,756,809,Cyprus
1050,2019-12,7492,4970,12462,New Zealand
1051,2020-01,8303,5010,13313,New Zealand
1052,2020-02,11166,4937,16103,New Zealand
1053,2020-03,9334,3712,13046,New Zealand
1054,2020-04,1004,627,1631,New Zealand
1055,2020-05,3436,779,4215,New Zealand
1056,2020-06,6359,857,7216,New Zealand
1057,2020-07,9329,874,10203,New Zealand
1058,2020-08,6134,538,6672,New Zealand
1059,2020-09,7906,510,8416,New Zealand
1060,2020-10,11488,917,12405,New Zealand
1061,2020-11,10320,986,11306,New Zealand
1062,2020-12,12413,1103,13516,New Zealand
1063,2021-01,12500,992,13492,New Zealand
1064,2019-12,261,7840,8101,Philippines
1065,2020-01,215,7123,7338,Philippines
1066,2020-02,211,6359,6570,Philippines
1067,2020-03,171,3749,3920,Philippines
1068,2020-04,37,840,877,Philippines
1069,2020-05,75,1195,1270,Philippines
1070,2020-06,170,1593,1763,Philippines
1071,2020-07,203,1801,2004,Philippines
1072,2020-08,148,1873,2021,Philippines
1073,2020-09,184,2046,2230,Philippines
1074,2020-10,194,2094,2288,Philippines
1075,2020-11,151,2183,2334,Philippines
1076,2020-12,189,2453,2642,Philippines
1077,2021-01,145,2037,2182,Philippines
1078,2019-12,35,1129,1164,Bangladesh
1079,2020-01,40,924,964,Bangladesh
1080,2020-02,49,1041,1090,Bangladesh
1081,2020-03,35,744,779,Bangladesh
1082,2020-04,43,37,80,Bangladesh
1083,2020-05,37,170,207,Bangladesh
1084,2020-06,61,287,348,Bangladesh
1085,2020-07,53,374,427,Bangladesh
1086,2020-08,58,384,442,Bangladesh
1087,2020-09,111,466,577,Bangladesh
1088,2020-10,60,723,783,Bangladesh
1089,2020-11,60,813,873,Bangladesh
1090,2020-12,16,555,571,Bangladesh
1091,2021-01,131,956,1087,Bangladesh
1092,2019-12,3,308,311,Pakistan
1093,2020-01,1,281,282,Pakistan
1094,2020-02,3,352,355,Pakistan
1095,2020-03,0,157,157,Pakistan
1096,2020-04,0,2,2,Pakistan
1097,2020-05,0,0,0,Pakistan
1098,2020-06,0,0,0,Pakistan
1099,2020-07,0,3,3,Pakistan
1100,2020-08,1,156,157,Pakistan
1101,2020-09,0,190,190,Pakistan
1102,2020-10,0,280,280,Pakistan
1103,2020-11,2,207,209,Pakistan
1104,2020-12,0,187,187,Pakistan
1105,2021-01,1,173,174,Pakistan
1106,2019-12,20,1890,1910,Sri Lanka
1107,2020-01,44,3317,3361,Sri Lanka
1108,2020-02,27,3147,3174,Sri Lanka
1109,2020-03,19,2057,2076,Sri Lanka
1110,2020-04,5,108,113,Sri Lanka
1111,2020-05,0,0,0,Sri Lanka
1112,2020-06,0,0,0,Sri Lanka
1113,2020-07,0,0,0,Sri Lanka
1114,2020-08,0,0,0,Sri Lanka
1115,2020-09,0,0,0,Sri Lanka
1116,2020-10,0,0,0,Sri Lanka
1117,2020-11,0,4,4,Sri Lanka
1118,2020-12,0,5,5,Sri Lanka
1119,2021-01,0,0,0,Sri Lanka
1120,2019-12,122,1265,1387,Slovakia
1121,2020-01,62,1157,1219,Slovakia
1122,2020-02,166,1233,1399,Slovakia
1123,2020-03,118,671,789,Slovakia
1124,2020-04,277,233,510,Slovakia
1125,2020-05,292,259,551,Slovakia
1126,2020-06,229,412,641,Slovakia
1127,2020-07,207,649,856,Slovakia
1128,2020-08,326,930,1256,Slovakia
1129,2020-09,320,804,1124,Slovakia
1130,2020-10,229,622,851,Slovakia
1131,2020-11,237,379,616,Slovakia
1132,2020-12,145,476,621,Slovakia
1133,2021-01,183,427,610,Slovakia
1134,2019-12,112,202,314,French Polynesia
1135,2020-01,153,203,356,French Polynesia
1136,2020-02,191,219,410,French Polynesia
1137,2020-03,132,174,306,French Polynesia
1138,2020-04,23,9,32,French Polynesia
1139,2020-05,33,9,42,French Polynesia
1140,2020-06,39,10,49,French Polynesia
1141,2020-07,12,14,26,French Polynesia
1142,2020-08,121,107,228,French Polynesia
1143,2020-09,142,142,284,French Polynesia
1144,2020-10,208,158,366,French Polynesia
1145,2020-11,181,126,307,French Polynesia
1146,2020-12,90,67,157,French Polynesia
1147,2021-01,87,70,157,French Polynesia
1148,2019-12,124,1013,1137,Mexico
1149,2020-01,143,1374,1517,Mexico
1150,2020-02,191,2158,2349,Mexico
1151,2020-03,39,260,299,Mexico
1152,2020-04,8,117,125,Mexico
1153,2020-05,7,117,124,Mexico
1154,2020-06,12,179,191,Mexico
1155,2020-07,11,206,217,Mexico
1156,2020-08,28,205,233,Mexico
1157,2020-09,411,1105,1516,Mexico
1158,2020-10,973,2651,3624,Mexico
1159,2020-11,725,2287,3012,Mexico
1160,2020-12,1424,5723,7147,Mexico
1161,2021-01,1095,5858,6953,Mexico
1162,2019-12,18,1025,1043,Brunei Darussalam
1163,2020-01,13,1043,1056,Brunei Darussalam
1164,2020-02,13,1012,1025,Brunei Darussalam
1165,2020-03,9,622,631,Brunei Darussalam
1166,2020-04,3,80,83,Brunei Darussalam
1167,2020-05,3,84,87,Brunei Darussalam
1168,2020-06,1,109,110,Brunei Darussalam
1169,2020-07,1,119,120,Brunei Darussalam
1170,2020-08,6,100,106,Brunei Darussalam
1171,2020-09,5,112,117,Brunei Darussalam
1172,2020-10,1,118,119,Brunei Darussalam
1173,2020-11,5,119,124,Brunei Darussalam
1174,2020-12,2,142,144,Brunei Darussalam
1175,2021-01,7,141,148,Brunei Darussalam
1176,2019-12,57,51,108,"Iran, Islamic Republic of"
1177,2020-01,40,64,104,"Iran, Islamic Republic of"
1178,2020-02,38,22,60,"Iran, Islamic Republic of"
1179,2020-03,43,15,58,"Iran, Islamic Republic of"
1180,2020-04,13,14,27,"Iran, Islamic Republic of"
1181,2020-05,19,3,22,"Iran, Islamic Republic of"
1182,2020-06,92,7,99,"Iran, Islamic Republic of"
1183,2020-07,63,31,94,"Iran, Islamic Republic of"
1184,2020-08,139,81,220,"Iran, Islamic Republic of"
1185,2020-09,106,42,148,"Iran, Islamic Republic of"
1186,2020-10,147,42,189,"Iran, Islamic Republic of"
1187,2020-11,112,31,143,"Iran, Islamic Republic of"
1188,2020-12,50,13,63,"Iran, Islamic Republic of"
1189,2021-01,8,1,9,"Iran, Islamic Republic of"
1190,2019-12,25,2569,2594,Macao
1191,2020-01,24,2550,2574,Macao
1192,2020-02,13,723,736,Macao
1193,2020-03,8,358,366,Macao
1194,2020-04,13,174,187,Macao
1195,2020-05,24,215,239,Macao
1196,2020-06,18,357,375,Macao
1197,2020-07,11,288,299,Macao
1198,2020-08,11,292,303,Macao
1199,2020-09,46,314,360,Macao
1200,2020-10,30,258,288,Macao
1201,2020-11,26,289,315,Macao
1202,2020-12,30,337,367,Macao
1203,2021-01,99,290,389,Macao
1204,2019-12,315,548,863,Indonesia
1205,2020-01,151,363,514,Indonesia
1206,2020-02,107,323,430,Indonesia
1207,2020-03,149,743,892,Indonesia
1208,2020-04,19,28,47,Indonesia
1209,2020-05,104,538,642,Indonesia
1210,2020-06,228,554,782,Indonesia
1211,2020-07,78,102,180,Indonesia
1212,2020-08,22,19,41,Indonesia
1213,2020-09,26,15,41,Indonesia
1214,2020-10,27,20,47,Indonesia
1215,2020-11,76,12,88,Indonesia
1216,2020-12,193,135,328,Indonesia
1217,2021-01,618,901,1519,Indonesia
1218,2019-12,0,15,15,Viet Nam
1219,2020-01,0,45,45,Viet Nam
1220,2020-02,1,28,29,Viet Nam
1221,2020-03,0,6,6,Viet Nam
1222,2020-04,0,0,0,Viet Nam
1223,2020-05,0,0,0,Viet Nam
1224,2020-06,266,320,586,Viet Nam
1225,2020-07,554,716,1270,Viet Nam
1226,2020-08,189,536,725,Viet Nam
1227,2020-09,48,1102,1150,Viet Nam
1228,2020-10,12,1291,1303,Viet Nam
1229,2020-11,24,1340,1364,Viet Nam
1230,2020-12,434,1543,1977,Viet Nam
1231,2021-01,860,1564,2424,Viet Nam
1232,2019-12,145,2445,2590,Puerto Rico
1233,2020-01,282,3809,4091,Puerto Rico
1234,2020-02,273,3792,4065,Puerto Rico
1235,2020-03,236,3982,4218,Puerto Rico
1236,2020-04,91,643,734,Puerto Rico
1237,2020-05,1,19,20,Puerto Rico
1238,2020-06,94,2267,2361,Puerto Rico
1239,2020-07,110,3800,3910,Puerto Rico
1240,2020-08,161,3164,3325,Puerto Rico
1241,2020-09,316,2741,3057,Puerto Rico
1242,2020-10,417,2946,3363,Puerto Rico
1243,2020-11,435,3651,4086,Puerto Rico
1244,2020-12,456,4389,4845,Puerto Rico
1245,2021-01,981,4765,5746,Puerto Rico
1246,2019-12,13,378,391,"Bolivia, Plurinational State of"
1247,2020-01,20,373,393,"Bolivia, Plurinational State of"
1248,2020-02,183,417,600,"Bolivia, Plurinational State of"
1249,2020-03,355,275,630,"Bolivia, Plurinational State of"
1250,2020-04,15,17,32,"Bolivia, Plurinational State of"
1251,2020-05,30,37,67,"Bolivia, Plurinational State of"
1252,2020-06,44,63,107,"Bolivia, Plurinational State of"
1253,2020-07,42,76,118,"Bolivia, Plurinational State of"
1254,2020-08,159,71,230,"Bolivia, Plurinational State of"
1255,2020-09,101,55,156,"Bolivia, Plurinational State of"
1256,2020-10,1,6,7,"Bolivia, Plurinational State of"
1257,2020-11,0,10,10,"Bolivia, Plurinational State of"
1258,2020-12,0,6,6,"Bolivia, Plurinational State of"
1259,2021-01,0,0,0,"Bolivia, Plurinational State of"
1260,2019-12,8,213,221,Bulgaria
1261,2020-01,7,188,195,Bulgaria
1262,2020-02,1,174,175,Bulgaria
1263,2020-03,0,111,111,Bulgaria
1264,2020-04,7,17,24,Bulgaria
1265,2020-05,2,75,77,Bulgaria
1266,2020-06,36,341,377,Bulgaria
1267,2020-07,50,1302,1352,Bulgaria
1268,2020-08,5,273,278,Bulgaria
1269,2020-09,7,228,235,Bulgaria
1270,2020-10,29,414,443,Bulgaria
1271,2020-11,44,396,440,Bulgaria
1272,2020-12,56,327,383,Bulgaria
1273,2021-01,38,267,305,Bulgaria
1274,2019-12,564,686,1250,Peru
1275,2020-01,240,147,387,Peru
1276,2020-02,262,95,357,Peru
1277,2020-03,93,74,167,Peru
1278,2020-04,3,16,19,Peru
1279,2020-05,4,20,24,Peru
1280,2020-06,14,11,25,Peru
1281,2020-07,57,12,69,Peru
1282,2020-08,121,24,145,Peru
1283,2020-09,135,42,177,Peru
1284,2020-10,81,29,110,Peru
1285,2020-11,125,106,231,Peru
1286,2020-12,37,104,141,Peru
1287,2021-01,34,100,134,Peru
1288,2019-12,1,444,445,Saint Vincent and the Grenadines
1289,2020-01,1,274,275,Saint Vincent and the Grenadines
1290,2020-02,2,466,468,Saint Vincent and the Grenadines
1291,2020-03,1,394,395,Saint Vincent and the Grenadines
1292,2020-04,0,5,5,Saint Vincent and the Grenadines
1293,2020-05,0,2,2,Saint Vincent and the Grenadines
1294,2020-06,0,3,3,Saint Vincent and the Grenadines
1295,2020-07,0,0,0,Saint Vincent and the Grenadines
1296,2020-08,0,3,3,Saint Vincent and the Grenadines
1297,2020-09,0,26,26,Saint Vincent and the Grenadines
1298,2020-10,3,115,118,Saint Vincent and the Grenadines
1299,2020-11,5,173,178,Saint Vincent and the Grenadines
1300,2020-12,0,345,345,Saint Vincent and the Grenadines
1301,2021-01,0,30,30,Saint Vincent and the Grenadines
1302,2019-12,0,27,27,Guinea-Bissau
1303,2020-01,0,4,4,Guinea-Bissau
1304,2020-02,0,29,29,Guinea-Bissau
1305,2020-03,0,29,29,Guinea-Bissau
1306,2020-04,0,0,0,Guinea-Bissau
1307,2020-05,0,10,10,Guinea-Bissau
1308,2020-06,0,4,4,Guinea-Bissau
1309,2020-07,0,0,0,Guinea-Bissau
1310,2020-08,0,0,0,Guinea-Bissau
1311,2020-09,0,0,0,Guinea-Bissau
1312,2020-10,0,0,0,Guinea-Bissau
1313,2020-11,0,0,0,Guinea-Bissau
1314,2020-12,0,0,0,Guinea-Bissau
1315,2021-01,0,0,0,Guinea-Bissau
1316,2019-12,0,112,112,Guatemala
1317,2020-01,2,113,115,Guatemala
1318,2020-02,0,113,113,Guatemala
1319,2020-03,0,64,64,Guatemala
1320,2020-04,0,3,3,Guatemala
1321,2020-05,19,50,69,Guatemala
1322,2020-06,9,163,172,Guatemala
1323,2020-07,39,390,429,Guatemala
1324,2020-08,64,409,473,Guatemala
1325,2020-09,75,470,545,Guatemala
1326,2020-10,96,825,921,Guatemala
1327,2020-11,75,972,1047,Guatemala
1328,2020-12,90,1410,1500,Guatemala
1329,2021-01,66,1406,1472,Guatemala
1330,2019-12,15,2,17,"Venezuela, Bolivarian Republic of"
1331,2020-01,10,1,11,"Venezuela, Bolivarian Republic of"
1332,2020-02,16,4,20,"Venezuela, Bolivarian Republic of"
1333,2020-03,8,0,8,"Venezuela, Bolivarian Republic of"
1334,2020-04,9,0,9,"Venezuela, Bolivarian Republic of"
1335,2020-05,0,0,0,"Venezuela, Bolivarian Republic of"
1336,2020-06,5,0,5,"Venezuela, Bolivarian Republic of"
1337,2020-07,8,0,8,"Venezuela, Bolivarian Republic of"
1338,2020-08,3,0,3,"Venezuela, Bolivarian Republic of"
1339,2020-09,6,0,6,"Venezuela, Bolivarian Republic of"
1340,2020-10,3,0,3,"Venezuela, Bolivarian Republic of"
1341,2020-11,5,0,5,"Venezuela, Bolivarian Republic of"
1342,2020-12,2,0,2,"Venezuela, Bolivarian Republic of"
1343,2021-01,8,0,8,"Venezuela, Bolivarian Republic of"
1344,2019-12,0,15,15,Grenada
1345,2020-01,0,3,3,Grenada
1346,2020-02,0,14,14,Grenada
1347,2020-03,0,8,8,Grenada
1348,2020-04,0,0,0,Grenada
1349,2020-05,0,0,0,Grenada
1350,2020-06,0,0,0,Grenada
1351,2020-07,0,0,0,Grenada
1352,2020-08,0,0,0,Grenada
1353,2020-09,0,1,1,Grenada
1354,2020-10,0,10,10,Grenada
1355,2020-11,0,6,6,Grenada
1356,2020-12,0,4,4,Grenada
1357,2021-01,0,0,0,Grenada
1358,2019-12,0,17,17,Uruguay
1359,2020-01,0,22,22,Uruguay
1360,2020-02,0,21,21,Uruguay
1361,2020-03,0,8,8,Uruguay
1362,2020-04,0,0,0,Uruguay
1363,2020-05,0,0,0,Uruguay
1364,2020-06,0,2,2,Uruguay
1365,2020-07,0,4,4,Uruguay
1366,2020-08,0,9,9,Uruguay
1367,2020-09,0,1,1,Uruguay
1368,2020-10,0,0,0,Uruguay
1369,2020-11,0,1,1,Uruguay
1370,2020-12,0,22,22,Uruguay
1371,2021-01,0,0,0,Uruguay
1372,2019-12,0,59,59,Jordan
1373,2020-01,0,75,75,Jordan
1374,2020-02,0,12,12,Jordan
1375,2020-03,0,1,1,Jordan
1376,2020-04,0,0,0,Jordan
1377,2020-05,0,0,0,Jordan
1378,2020-06,0,0,0,Jordan
1379,2020-07,0,0,0,Jordan
1380,2020-08,0,0,0,Jordan
1381,2020-09,2,18,20,Jordan
1382,2020-10,1,26,27,Jordan
1383,2020-11,0,28,28,Jordan
1384,2020-12,0,7,7,Jordan
1385,2021-01,0,32,32,Jordan
1386,2019-12,0,1,1,Kuwait
1387,2020-01,0,0,0,Kuwait
1388,2020-02,0,2,2,Kuwait
1389,2020-03,0,1,1,Kuwait
1390,2020-04,0,1,1,Kuwait
1391,2020-05,0,0,0,Kuwait
1392,2020-06,0,1,1,Kuwait
1393,2020-07,0,46,46,Kuwait
1394,2020-08,0,60,60,Kuwait
1395,2020-09,1,182,183,Kuwait
1396,2020-10,1,100,101,Kuwait
1397,2020-11,1,12,13,Kuwait
1398,2020-12,0,1,1,Kuwait
1399,2021-01,0,16,16,Kuwait
1400,2019-12,0,3,3,Tunisia
1401,2020-01,0,0,0,Tunisia
1402,2020-02,0,113,113,Tunisia
1403,2020-03,0,47,47,Tunisia
1404,2020-04,0,8,8,Tunisia
1405,2020-05,0,14,14,Tunisia
1406,2020-06,0,36,36,Tunisia
1407,2020-07,0,135,135,Tunisia
1408,2020-08,0,181,181,Tunisia
1409,2020-09,0,76,76,Tunisia
1410,2020-10,0,111,111,Tunisia
1411,2020-11,1,105,106,Tunisia
1412,2020-12,0,0,0,Tunisia
1413,2021-01,0,0,0,Tunisia
1414,2019-12,0,15,15,Martinique
1415,2020-01,0,1,1,Martinique
1416,2020-02,0,4,4,Martinique
1417,2020-03,0,1,1,Martinique
1418,2020-04,0,0,0,Martinique
1419,2020-05,0,0,0,Martinique
1420,2020-06,0,0,0,Martinique
1421,2020-07,0,0,0,Martinique
1422,2020-08,0,0,0,Martinique
1423,2020-09,0,1,1,Martinique
1424,2020-10,0,0,0,Martinique
1425,2020-11,0,0,0,Martinique
1426,2020-12,0,0,0,Martinique
1427,2021-01,0,0,0,Martinique
1428,2019-12,0,2,2,Nepal
1429,2020-01,32,763,795,Nepal
1430,2020-02,36,519,555,Nepal
1431,2020-03,14,435,449,Nepal
1432,2020-04,0,0,0,Nepal
1433,2020-05,0,0,0,Nepal
1434,2020-06,0,0,0,Nepal
1435,2020-07,0,0,0,Nepal
1436,2020-08,0,0,0,Nepal
1437,2020-09,0,0,0,Nepal
1438,2020-10,0,2,2,Nepal
1439,2020-11,1,0,1,Nepal
1440,2020-12,4,0,4,Nepal
1441,2021-01,2,0,2,Nepal
1442,2019-12,0,1,1,Lao People's Democratic Republic
1443,2020-01,0,0,0,Lao People's Democratic Republic
1444,2020-02,0,0,0,Lao People's Democratic Republic
1445,2020-03,0,0,0,Lao People's Democratic Republic
1446,2020-04,0,0,0,Lao People's Democratic Republic
1447,2020-05,0,0,0,Lao People's Democratic Republic
1448,2020-06,0,0,0,Lao People's Democratic Republic
1449,2020-07,0,0,0,Lao People's Democratic Republic
1450,2020-08,0,0,0,Lao People's Democratic Republic
1451,2020-09,0,0,0,Lao People's Democratic Republic
1452,2020-10,0,0,0,Lao People's Democratic Republic
1453,2020-11,0,0,0,Lao People's Democratic Republic
1454,2020-12,0,0,0,Lao People's Democratic Republic
1455,2021-01,0,0,0,Lao People's Democratic Republic
1456,2019-12,0,3,3,Gibraltar
1457,2020-01,0,11,11,Gibraltar
1458,2020-02,0,15,15,Gibraltar
1459,2020-03,0,8,8,Gibraltar
1460,2020-04,0,1,1,Gibraltar
1461,2020-05,0,7,7,Gibraltar
1462,2020-06,0,25,25,Gibraltar
1463,2020-07,0,79,79,Gibraltar
1464,2020-08,0,88,88,Gibraltar
1465,2020-09,0,46,46,Gibraltar
1466,2020-10,0,40,40,Gibraltar
1467,2020-11,0,31,31,Gibraltar
1468,2020-12,0,19,19,Gibraltar
1469,2021-01,0,8,8,Gibraltar
1470,2019-12,0,45,45,Bosnia and Herzegovina
1471,2020-01,0,32,32,Bosnia and Herzegovina
1472,2020-02,0,38,38,Bosnia and Herzegovina
1473,2020-03,0,27,27,Bosnia and Herzegovina
1474,2020-04,0,4,4,Bosnia and Herzegovina
1475,2020-05,0,5,5,Bosnia and Herzegovina
1476,2020-06,0,19,19,Bosnia and Herzegovina
1477,2020-07,0,23,23,Bosnia and Herzegovina
1478,2020-08,0,43,43,Bosnia and Herzegovina
1479,2020-09,0,15,15,Bosnia and Herzegovina
1480,2020-10,0,21,21,Bosnia and Herzegovina
1481,2020-11,0,19,19,Bosnia and Herzegovina
1482,2020-12,0,19,19,Bosnia and Herzegovina
1483,2021-01,0,13,13,Bosnia and Herzegovina
1484,2019-12,0,1,1,Trinidad and Tobago
1485,2020-01,0,1,1,Trinidad and Tobago
1486,2020-02,0,1,1,Trinidad and Tobago
1487,2020-03,0,0,0,Trinidad and Tobago
1488,2020-04,0,0,0,Trinidad and Tobago
1489,2020-05,0,0,0,Trinidad and Tobago
1490,2020-06,0,0,0,Trinidad and Tobago
1491,2020-07,0,0,0,Trinidad and Tobago
1492,2020-08,0,0,0,Trinidad and Tobago
1493,2020-09,0,0,0,Trinidad and Tobago
1494,2020-10,6,4,10,Trinidad and Tobago
1495,2020-11,0,0,0,Trinidad and Tobago
1496,2020-12,0,0,0,Trinidad and Tobago
1497,2021-01,0,0,0,Trinidad and Tobago
1498,2019-12,0,1,1,Western Sahara
1499,2020-01,0,0,0,Western Sahara
1500,2020-02,0,0,0,Western Sahara
1501,2020-03,0,0,0,Western Sahara
1502,2020-04,0,0,0,Western Sahara
1503,2020-05,0,0,0,Western Sahara
1504,2020-06,0,0,0,Western Sahara
1505,2020-07,0,0,0,Western Sahara
1506,2020-08,0,0,0,Western Sahara
1507,2020-09,0,0,0,Western Sahara
1508,2020-10,0,0,0,Western Sahara
1509,2020-11,0,0,0,Western Sahara
1510,2020-12,0,0,0,Western Sahara
1511,2021-01,0,0,0,Western Sahara
